bird	flock
calf	cattle/herd
car	train/procession
cattle	herd
christian	congregation/church/parish
college	university
county	state/country
cow	herd
crow	murder
elephant	herd
employee	staff/company
fish	school
galaxy	universe
letter	alphabet
lion	pride
listener	audience
member	club/team/group/band/community
musician	orchestra/band
person	society/company/party/world
photo	album/collection/library
player	team/group/orchestra
policeman	police
secretary	staff
senator	senate/house
sheep	flock
soldier	army/unit/division/troop
spouse	couple/relationship/family
state	country/province
student	class/school
tree	forest/wood/grove
wolf	pack
word	paragraph/sentence/text
