believe	believer
compose	composer
consume	consumer
contend	contender
defend	defender
develop	developer
examine	examiner
explore	explorer
follow	follower
interpret	interpreter
listen	listener
lose	loser
manage	manager
observe	observer
organize	organizer
perform	performer
preach	preacher
promote	promoter
provide	provider
publish	publisher
receive	receiver
speak	speaker
teach	teacher
write	writer
