athens	greece
baghdad	iraq
bangkok	thailand
beijing	china
berlin	germany
bern	switzerland
brussels	belgium
budapest	hungary
cairo	egypt
copenhagen	denmark
damascus	syria
dublin	ireland
helsinki	finland
kingston	jamaica
lisbon	portugal
madrid	spain
manila	philippines
moscow	russia
oslo	norway
ottawa	canada
paris	france
rome	italy
santiago	chile
stockholm	sweden
tehran	iran
tokyo	japan
vienna	austria
warsaw	poland
