argentina	spanish
australia	english
austria	german
brazil	portuguese
canada	english/french
chile	spanish
colombia	spanish
cuba	spanish
cyprus	greek/turkish
egypt	arabic
guatemala	spanish
iran	persian
iraq	arabic/kurdish
israel	hebrew/arabic
jordan	arabic
kuwait	arabic
palestine	arabic
peru	spanish
switzerland	german/french/italian
syria	arabic
taiwan	chinese
usa	english
venezuela	spanish
